Note: Anything with a blank reward here is just a "Bet Punishment" fight against Typhon. You won't lose your item if you fight him, but you 
will waste your time.

               Dagger (Dagger  ) =>        Mythril Knife [vs. Goblin  ]
        Mythril Knife (Mythril ) =>          Main Gauche [vs. GardLedr]
          Main Gauche (MainGauc) =>            Air Knife [vs. MtrDrive]
            Air Knife (Air     ) =>        Thief's Knife [vs. Chimera ]
        Thief's Knife (Thief   ) =>    Assassin's Dagger [vs. DrgnZomb]
    Assassin's Dagger (Assassin) =>        Needle Dagger [vs. Brainpan]
       Dancing Dagger (Dancing ) =>              Gladius [vs. Deathclw]
              Gladius (Gladius ) =>       Enhancer Sword [vs. Baalzeph]
        Valiant Knife (Valiant ) => ---
        Mythril Sword (Mythril ) =>          Great Sword [vs. Fem.Sold]
          Great Sword (Great   ) =>           Rune Blade [vs. SandFish]
           Rune Blade (Rune    ) =>       Enhancer Sword [vs. Kamui   ]
          Flametongue (Flametng) =>             Icebrand [vs. WhtJello]
             Icebrand (Icebrand) =>        Thunder Blade [vs. RedMarsh]
        Thunder Blade (Thunder ) =>          Flametongue [vs. YellowMo]
       Enhancer Sword (Enhancer) =>        Crystal Sword [vs. KilrMnts]
        Crystal Sword (Crystal ) =>             Defender [vs. Devil   ]
           Stoneblade (Stone   ) =>          Blood Sword [vs. Valefor ]
         Shadow Blade (Shadow  ) =>           Rune Blade [vs. HvyArmor]
          Blood Sword (Blood   ) =>          Blood Lance [vs. DemonKht]
             Hrunting (Hrunting) =>                 Gram [vs. GlasyaLa]
                 Gram (Gram    ) =>              Balmung [vs. Silenus ]
            Arondight (Arondght) =>                 Gram [vs. Apanda  ]
              Balmung (Balmung ) =>            Arondight [vs. SnwPanth]
             Defender (Defender) =>             Durandal [vs. NghtHawk]
             Durandal (Durandal) =>          Royal Crown [vs. Alv     ]
       Save the Queen (SavetheQ) => ---
             Ragnarok (Ragnarok) => ---
          Zantetsuken (Zantetsu) => ---
        Mythril Spear (Mythril ) =>          Heavy Lance [vs. PlatDrgn]
          Heavy Lance (Heavy   ) =>              Trident [vs. Dante   ]
              Trident (Trident ) =>             Partisan [vs. TestRidr]
             Partisan (Partisan) =>         Dragon Spear [vs. Brachios]
          Blood Lance (Blood   ) =>          Lamia Brush [vs. LamiaQen]
        Radiant Lance (Radiant ) => ---
              Gungnir (Gungnir ) => ---
         Dragon Spear (Dragon  ) =>        Dragoon Boots [vs. Aeronite]
                Kunai (Kunai   ) =>              Kodachi [vs. Graswyrm]
              Kodachi (Kodachi ) =>               Sakura [vs. Ninja   ]
               Sakura (Sakura  ) =>               Izayoi [vs. Mykale  ]
               Izayoi (Izayoi  ) =>             Murasame [vs. Chronos ]
          Narigitsune (Narigits) => Narigitsune (Shadow) [vs. Covert  ]
              Kagenui (Kagenui ) =>        Fuma Shuriken [vs. Covert  ]
               Ashura (Ashura  ) =>              Kotetsu [vs. Sahagin ]
              Kotetsu (Kotetsu ) =>              Osafune [vs. Sergeant]
              Osafune (Osafune ) =>        Kikuichimonji [vs. Samurai ]
        Kikuichimonji (Kikuichi) =>             Muramasa [vs. Yojimbo ]
             Muramasa (Muramasa) =>             Murasame [vs. Sam.Soul]
          Mutsunokami (Mutsunok) => ---
             Murasame (Murasame) =>              Kagenui [vs. NinjaMas]
             Murakumo (Murakumo) => ---
        Battle Bamboo (B.Bamboo) =>        Octagon Staff [vs. Imp     ]
        Healing Staff (Healing ) =>               Elixir [vs. Daedalus]
            Flame Rod (Flame   ) =>             Holy Rod [vs. Pineappl]
              Ice Rod (Ice     ) =>             Holy Rod [vs. Traveler]
          Thunder Rod (Thunder ) =>             Holy Rod [vs. Jam     ]
        Octagon Staff (Octagon ) =>          Dragon Claw [vs. Dragon  ]
             Holy Rod (Holy    ) =>        Healing Staff [vs. Titania ]
            Kenkonken (Kenkonkn) => ---
            Bone Club (Bone    ) => ---
         Mace of Zeus (Zeus    ) => ---
        Chocobo Brush (Chocobo ) =>        Magical Brush [vs. RicardMg]
        Magical Brush (Magical ) =>        Rainbow Brush [vs. Maiden  ]
          Lamia Brush (Lamia   ) =>          Blood Sword [vs. Haokah  ]
        Rainbow Brush (Rainbow ) =>             Cat Hood [vs. Tonberry]
             Shuriken (Shuriken) =>       Moonring Blade [vs. Harveste]
        Fuma Shuriken (Fuma    ) =>           Rising Sun [vs. Outsider]
             Pinwheel (Pinwheel) => ---
          Mythril Axe (Mythril ) =>              Slasher [vs. ImpElite]
           Rising Sun (Rising S) =>              Antares [vs. Neochu  ]
           Flame Whip (Flame   ) =>         Diamond Bell [vs. Purusa  ]
            Boomerang (Boomrang) =>       Moonring Blade [vs. Ninja   ]
       Moonring Blade (Moonring) =>             Shuriken [vs. Samurai ]
              Slasher (Slasher ) =>            Boomerang [vs. SahagChf]
           Chain Whip (Chain   ) =>           Blitz Whip [vs. Venobenu]
           Blitz Whip (Blitz   ) =>           Flame Whip [vs. Chs.Drgn]
          Gaia Hammer (Gaia    ) => ---
         Diamond Bell (Diamond ) =>        Healing Staff [vs. St. Elmo]
                Cards (Cards   ) =>                Darts [vs. Devourer]
                Darts (Darts   ) =>                 Dice [vs. Don     ]
                 Dice (Dice    ) =>    Tarot de Bennstat [vs. BlkDragn]
    Tarot de Bennstat (Bennstat) =>              Antares [vs. Twinscyt]
           Fixed Dice (FixdDice) => ---
              Antares (Antares ) =>          Lamia Brush [vs. DthWarde]
          Last Resort (L.Resort) => ---
        Metal Knuckle (Metal   ) =>         Mythril Claw [vs. Zaghrem ]
         Mythril Claw (Mythril ) =>       Kaiser Knuckle [vs. LesLopro]
       Kaiser Knuckle (Kaiser  ) =>            Dark Claw [vs. DrgnFosl]
            Dark Claw (Dark    ) =>      Burning Knuckle [vs. Balloon ]
      Burning Knuckle (Burning ) =>          Dragon Claw [vs. Dragon  ]
              Buckler (Buckler ) =>         Large Shield [vs. SOLDIER ]
         Large Shield (Large   ) =>       Mythril Shield [vs. Templar ]
          Dragon Claw (Dragon  ) =>           Tiger Fang [vs. GrndBehe]
           Tiger Fang (Tiger   ) =>        Behemoth Suit [vs. DarkBehe]
      Marvelous Cheer (MrvlsChr) => ---
         Lightbringer (L.Bringr) => ---
           Gekkabijin (Gekkabij) => ---
        Ultima Weapon (Ultima  ) => ---
      Artemis's Brush (Artemis ) => ---
        Kitchen Knife (Kitchen ) => ---
        Needle Dagger (Needle  ) =>       Dancing Dagger [vs. Amduscia]
        Maduin's Horn (MaduinHr) => ---
           Orichalcum (Orichalc) => ---
            Excalibur (Excalibr) => ---
           Soul Eater (SoulEatr) => ---
             Masamune (Masamune) => ---
      Sasuke's Katana (Sasuke  ) => ---
           Wizard Rod (Wizard  ) => ---
          Elven Darts (Elven   ) => ---
         Earthbreaker (Erthbrkr) => ---
       Dragon Whisker (D.Whiskr) => ---
           Holy Lance (Holy    ) => ---
             God Hand (Godhand ) => ---
            Rune Bell (Rune    ) => ---
       Mythril Shield (Mythril ) =>          Gold Shield [vs. MTekInfa]
          Gold Shield (Gold    ) =>       Diamond Shield [vs. Mindflyr]
         Flame Shield (Flame   ) =>           Ice Shield [vs. Frostbst]
           Ice Shield (Ice     ) =>       Thunder Shield [vs. MuudSuud]
       Thunder Shield (Thunder ) =>         Flame Shield [vs. FlameDog]
       Diamond Shield (Diamond ) =>       Crystal Shield [vs. Crawler ]
       Crystal Shield (Crystal ) =>         Crystal Helm [vs. Wild Cat]
         Aegis Shield (Aegis   ) => ---
         Force Shield (Force   ) => ---
         Genji Shield (Genji   ) =>           Genji Helm [vs. GrtMalbo]
        Cursed Shield (Cursed  ) => ---
        Hero's Shield (Hero    ) => ---
         La Seraphica (LaSeraph) => ---
          Leather Hat (Leather ) =>           Plumed Hat [vs. Cockatri]
           Plumed Hat (Plumed  ) =>             Headgear [vs. Onion   ]
             Headgear (Headgear) =>          Green Beret [vs. IronClaw]
            Magus Hat (Magus   ) =>       Priest's Miter [vs. Phoebe  ]
       Priest's Miter (Priest  ) =>         Mystery Veil [vs. Lamia   ]
          Green Beret (GreenBrt) =>       Twist Headband [vs. MtrDrive]
       Twist Headband (TwstHead) =>           Black Cowl [vs. SandFish]
         Gold Hairpin (G.Hairpn) => ---
         Mystery Veil (Mystery ) =>          White Dress [vs. Fawn    ]
           Black Cowl (Black   ) =>           Black Garb [vs. Carrot  ]
            Oath Veil (Oath    ) =>           Magus Robe [vs. MagiDrgn]
          Djinn's Cap (Djinn   ) =>          Ward Bangle [vs. Soulflyr]
             Cat Hood (Cat Hood) =>          Moogle Suit [vs. Lukhavi ]
          Lambent Hat (Lambent ) => ---
            Iron Helm (Iron    ) =>         Mythril Helm [vs. Fem.Sold]
         Mythril Helm (Mythril ) =>            Gold Helm [vs. ProtoAmr]
            Gold Helm (Gold    ) =>         Diamond Helm [vs. Apocryph]
         Diamond Helm (Diamond ) =>         Crystal Helm [vs. Vampires]
              Circlet (Circlet ) =>            Oath Veil [vs. Joker   ]
         Crystal Helm (Crystal ) =>         Crystal Mail [vs. Mahadeva]
          Royal Crown (RoyalCrn) => ---
           Genji Helm (Genji   ) =>          Genji Armor [vs. SkullEtr]
           Grand Helm (Grand   ) => ---
             Barrette (Barrette) =>             Cachusha [vs. UndCheru]
             Cachusha (Cachusha) =>             Barrette [vs. Maiden  ]
               Ribbon (Ribbon  ) => ---
          Cotton Robe (Cotton  ) =>           Magus Robe [vs. Shade   ]
             Kenpo Gi (Kenpo Gi) =>        Mythril Plate [vs. Al Jabr ]
        Mythril Plate (Mythril ) =>           Ninja Gear [vs. StrayCat]
           Ninja Gear (Ninja   ) =>           Power Sash [vs. Gorgimer]
          White Dress (WhtDress) =>            Oath Veil [vs. Misty   ]
            Gaia Gear (Gaia    ) =>           Stoneblade [vs. PiscoDmn]
          Moogle Suit (Moogle  ) =>             Cat Hood [vs. AlurRide]
           Power Sash (Power   ) =>           Black Garb [vs. B. Lamia]
           Black Garb (Blk.Garb) =>           Rising Sun [vs. Outsider]
           Magus Robe (Magus   ) =>             Holy Rod [vs. InnoSent]
         Noiseblaster (Noisblst) =>           Bioblaster [vs. MTekArmr]
           Bioblaster (Bioblast) =>                Flash [vs. SkyArmor]
                Flash (Flash   ) =>                Drill [vs. MegaArmr]
             Chainsaw (Chainsaw) =>          Blood Lance [vs. Fortis  ]
        Particle Bomb (PartBomb) => ---
                Drill (Drill   ) =>             Chainsaw [vs. Helldive]
           Air Anchor (AirAnchr) => ---
        Auto Crossbow (A.Crsbow) =>         Noiseblaster [vs. Belzecue]
         Flame Scroll (Flame   ) =>         Water Scroll [vs. RockSlug]
         Water Scroll (Water   ) =>       Thunder Scroll [vs. Hedgehog]
       Thunder Scroll (Thunder ) =>         Flame Scroll [vs. Rudra   ]
          Invi Scroll (Invis   ) =>        Shadow Scroll [vs. Bomb    ]
        Shadow Scroll (Shadow  ) =>  Invisibility Scroll [vs. Provoker]
           White Robe (White   ) =>           Black Robe [vs. BlkForce]
           Black Robe (Black   ) =>           White Robe [vs. Vilia   ]
          Mirage Vest (Mirage  ) =>      Minerva Bustier [vs. Alchymia]
      Minerva Bustier (Minerva ) =>          Mirage Vest [vs. CrysDrgn]
     Pheasant Netsuke (Pheasant) =>         Gale Hairpin [vs. Ochiudo ]
          Rubber Suit (Rubber  ) => ---
           Snow Scarf (SnowScrf) =>           Power Belt [vs. Tonber.M]
        Behemoth Suit (Behemoth) =>           Snow Scarf [vs. Thor    ]
        Leather Armor (Leather ) =>           Iron Armor [vs. Dstroide]
           Iron Armor (Iron    ) =>        Mythril Armor [vs. HilGigas]
        Mythril Armor (Mythril ) =>           Gold Armor [vs. Chaser  ]
           Gold Armor (Gold    ) =>        Diamond Armor [vs. Behemoth]
        Diamond Armor (Diamond ) =>         Crystal Mail [vs. Sorath  ]
         Crystal Mail (Crystal ) =>         Reflect Mail [vs. DuelArmr]
         Reflect Mail (Reflect ) =>         Reflect Ring [vs. Deep One]
          Force Armor (Force   ) => ---
          Genji Armor (Genji   ) =>         Genji Shield [vs. Alv     ]
          Maximillian (Maxmilln) => ---
    Silver Spectacles (SlvrSpec) =>           White Cape [vs. Mandrago]
           White Cape (White   ) =>          White Dress [vs. NeckHntr]
         Jeweled Ring (Jeweled ) =>           Peace Ring [vs. DiveEagl]
         Protect Ring (Protect ) =>         Jeweled Ring [vs. Bonnacon]
       Hermes Sandals (Hermes  ) =>          Ward Bangle [vs. LeapFrog]
         Reflect Ring (Reflect ) =>         Reflect Mail [vs. MtlHitmn]
        Feather Boots (Feather ) =>         Zephyr Cloak [vs. Minity  ]
     Gyshal Potpourri (GyshlPot) =>         Star Pendant [vs. Belmodar]
        Knight's Code (KnhtCode) =>          Hyper Wrist [vs. Oceanus ]
        Dragoon Boots (Dragoon ) =>              Circlet [vs. LunarWlf]
         Zephyr Cloak (Zephyr  ) =>         Gale Hairpin [vs. Sprinter]
             Earrings (Earrings) =>         Protect Ring [vs. DsrtSaha]
          Gigas Glove (Gigas   ) =>        Diamond Armor [vs. Revnant ]
       Thief's Bracer (ThiefBrc) =>         Thief Gloves [vs. Mugbear ]
              Mjolnir (Mjolnir ) => ---
         Thief Gloves (Thief   ) =>        Thief's Knife [vs. Borghese]
             Gauntlet (Gauntlet) =>          Genji Glove [vs. Azrael  ]
          Genji Glove (Genji   ) =>             Gauntlet [vs. VectorLy]
          Hyper Wrist (Hyper   ) =>          Gigas Glove [vs. Lycaon  ]
        Heiji's Jitte (Heiji   ) =>     Pheasant Netsuke [vs. Haniel  ]
          Merit Award (MeritAwr) => ---
         Memento Ring (Memento ) => ---
       Molulu's Charm (Molulu  ) => ---
          Ward Bangle (WardBngl) =>          Djinn's Cap [vs. GtMantis]
        Alarm Earring (Alarm   ) =>           Sniper Eye [vs. Aepyorni]
         Gale Hairpin (Gale HP ) =>        Heiji's Jitte [vs. Schmidt ]
           Sniper Eye (SnipeEye) =>        Auto Crossbow [vs. LandGril]
         Star Pendant (StarPend) =>             Earrings [vs. ChipRabb]
               Amulet (Amulet  ) =>     Gyshal Potpourri [vs. CloudWth]
          Tynar Rouge (T. Rouge) => ---
        Lunar Curtain (Lunar   ) =>               Amulet [vs. Necroman]
           Peace Ring (Peace   ) =>         Reflect Ring [vs. Hecto   ]
           Power Belt (Power   ) => ---
       Berserker Ring (Berserkr) => ---
        Floral Fallal (Floral  ) =>      Minerva Bustier [vs. Vivian  ]
         Lordly Robes (Lordly  ) => ---
         Omega Weapon (Omega   ) => ---
         Strength Tab (Str. Tab) =>            Speed Tab [vs. IrnGiant]
               Potion (Potion  ) =>            Hi-Potion [vs. Domovoi ]
            Hi-Potion (HiPotion) =>                Ether [vs. Lunatys ]
             X-Potion (X-Potion) =>              X-Ether [vs. Colossus]
                Ether (Ether   ) =>             Hi-Ether [vs. Coolness]
             Hi-Ether (Hi-Ether) =>           Dried Meat [vs. Stunner ]
              X-Ether (X-Ether ) =>             X-Potion [vs. Vanguard]
               Elixir (Elixir  ) =>            Megalixir [vs. Kum Kum ]
            Megalixir (Megalixr) =>        Reincarnation [vs. DonTonbe]
         Phoenix Down (Phx.Down) =>            Speed Tab [vs. Outcast ]
            Speed Tab (SpeedTab) =>          Stamina Tab [vs. Kum Kum ]
          Stamina Tab (Stm. Tab) =>            Magic Tab [vs. CrysDrgn]
            Magic Tab (MagicTab) =>         Strength Tab [vs. Cartagra]
         Golden Apple (GoldAppl) =>            Soma Drop [vs. LilMurde]
               Remedy (Remedy  ) =>        Lunar Curtain [vs. Malboro ]
            Soma Drop (SomaDrop) =>         Golden Apple [vs. Coeurl  ]
                 Tent (Tent    ) =>           Plumed Hat [vs. NutEater]
             Antidote (Antidote) =>           White Cape [vs. Bld.Fang]
       Smelling Salts (SmelSalt) =>               Elixir [vs. IrnGiant]
        Reincarnation (Reincarn) =>            Megalixir [vs. SoulEatr]
           Holy Water (HolyWatr) =>     Gyshal Potpourri [vs. LitworCh]
           Smoke Bomb (SmokeBmb) =>          Gold Needle [vs. WilloWsp]
          Gold Needle (GoldNeed) =>           Smoke Bomb [vs. LivingDe]
           Dried Meat (Dry Meat) =>          Mythril Axe [vs. Goetia  ]
              Nothing (Empty   ) => ---
          Hero's Ring (Brave   ) => ---
       Guard Bracelet (GrdBrace) => ---
            Dead Soul (DeadSoul) => ---
         Prayer Beads (PrayBead) => ---
           Black Belt (BlckBelt) => ---
          Dragon Horn (DrgnHorn) => ---
           Celestriad (Celestri) => ---
      Master's Scroll (MstrScrl) => ---
     Bacchus's Bracer (Bacchus ) => ---
           Safety Bit (Safe.Bit) => ---
    Mime's Dictionary (MimeBook) => ---
               Bracer (Bracer  ) => ---
      Tetra Elemental (TetrElem) => ---
   Embroidered Tippet (E.Tippet) => ---
      Soul of Thamasa (SoulTham) => ---
             Zeidrich (Zeidrich) => ---
           Flame Cape (Flame   ) => ---
         Wind Corsage (WCorsage) => ---
        Earth Greaves (Earth   ) => ---
          Water Cuffs (Water   ) => ---
      Maiden's Prayer (MaidPray) => ---
       Imp's Feelings (ImpFeels) => ---
        Piggy's Badge (PigBadge) => ---